girar - spin
sorpresa - surprise
maceta - pot
historiador - historian
enjuagar - rinse
casilla - square
signo - sign
importar - import
profesional - professional
ficha - piece
patines - skates
historia -  history
tornillo - screw
cantante - singer
insulto - insult
firma - sign
lechuga - lettuce
tiza - chalk
adoptar - adopt
pila -  battery
ciudad - city
rail - rail
frontera - border
prisionero - prisoner
capullo - cocoon
anchoa - anchovy
opinión - opinion
pierna - leg
hábito - habit
hueso - bone
